الدولة :العملة
الصين : يوان
الهند : روبية هندية
اندونيسيا : روبية اندونيسية
باكستان : روبية باكستانية
بنجلاديش : تاكا بنجلاديشى
اليابان : ين
الفلبين : بيسو فلبينى
فيتنام : دونج فيتنامى
سوريا : الليرة السورية
ايران : تومان
تايلاند : باهت
ميانمار : كيات
كوريا الجنوبية : وون
العراق : الدينار العراقى
نيبال : روبية نيبالى
ماليزيا : رنجت ماليزى
افغانستان : افغانى
اوزباكستان : سوم اوزباكستانى
السعودية : الريال السعودى
كوريا الشمالية : ون كوري
تايوان : دولار تايوانى
اليمن : ريال يمنى
سريلانكا : روبية سريلانكى
كازاخستان : تينغ كازاخستاني
كمبوديا : ريال كمبودى
هونج كونج : دولار هونج كونجى
لاوس : كيب
طاجيكستان : سامانى طاجيكى
الاردن : الدينار الاردنى
قيزيغزستان : سوم قيزيغزستانى
تركمانستان : مانات
سنغافورة : دولار سنغافورى
الامارات : الدرهم الاماراتى
لبنان : الليرة اللبنانية
فلسطين : الجنيه الفلسطينى
الكويت : الدينار الكويتى
منغوليا :توغروغ
عمان : ريال عمانى
تيمور الشرقية : الدولار الامريكى
قطر :الريال القطرى
البحرين : الدينار البحرينى
بوتان : نيغولترم
ماكاو : باتاكا
بروناى : دولار برونى
مالديف : روبيه مالديفيه