الدولة : العاصمة
 مصر : القاهرة
 ليبيا : طرابلس
 تونس : تونس
 الجزائر : الجزائر
 المغرب : الرباط
 السودان : الخرطوم
 موريتانيا : نواكشوط
 جزر القمر : موروني
 جيبوتي : جيبوتي
 الصومال : مقديشو
 الصحراء الغربية : العيون
 نيجيريا : ابوجا
 بوروندي : بوجمبورا
 انجولا : لواندا
 كينيا : نيروبي
 اثيوبيا : اديس ابابا
 الكاميرون : ياوندي
 جنوب افريقيا : بريتوريا
 غانا : اكرا
 غينيا : كوناكري
 غينيا بيساو : بيساو
 عينيا الاستوائية : مالابو
 زامبيا : لوساكا
 جامبيا : بانجول
 زمبابواي : هاراري
 مالي : باماكو
 ليبيريا : مونروفيا
 افريقيا الوسطي : بانجي
 اريتريا : اسمارا
 تنزانيا : دودوما
 اوغندا : كمبالا
 الكونغو اليموقراطية : كينشاسا
 الكونغو : برازافيل
 الجابون : ليبرفيل
 رواندا : كيجالي
 ملاوي : ليلونجوي
 ليسوتو : ماسيرو
 موريشيوس : بورلويس
 سوازيلاند : "مبابان" عاصمة ادارية
 سوازيلاند : "لوبانبا" عاصمة ملكية
 بروندى : بوجمبورا
 كوت ديفوار : ياموسوكرو
 ناميبيا : وندهوك
 بوتسوانا : جابورون
 النيجر : نيامى
 السنغال : داكار
 سيراليون : فرى تاون
 بوركينا فاسو : واجادوجو
 توجو : لومى
 بنين : بورتونوفو
 مدغشقر : انتاناناريفو
 موزمبيق : مابوتو
 سيشل : انجامينا
 الرأس الأخضر : برايا
 ساوتومى وبرنيسيبى : ساوتومى