الدولة :العاصمة
الصين : بكين
الهند : نيودلهى
اندونيسيا : جاكرتا
باكستان : اسلام اباد
بنجلاديش : دكا
اليابان : طوكيو
الفلبين : مانيلا
فيتنام : هانوى
سوريا : دمشق
ايران : طهران
تايلاند : بانكوك
ميانمار : رانجون
كوريا الجنوبية : سيول
العراق : بغداد
نيبال : كاثماندو
ماليزيا : كوالالمبور
افغانستان : كابول
اوزباكستان : طشقند
السعودية : الرياض
كوريا الشمالية : بيونج يانج
تايوان : تايبيه
اليمن : صنعاء
سريلانكا : كولومبو
كازاخستان : أستانا
كمبوديا : بنوم بنه
هونج كونج : فيكتوريا
لاوس : فيينتيان
طاجيكستان : دوشنبه
الاردن : عمان
قيزيغزستان : بشكيك
تركمانستان : عشق اباد
سنغافورة : سنغافورة
الامارات : ابوظبى
لبنان : بيروت
فلسطين : القدس
الكويت : الكويت
منغوليا : اولان باتور
عمان : مسقط
تيمور الشرقية : ديلي
قطر : الدوحة
البحرين : المنامة
بوتان : تيمفو
ماكاو : ماكاو سيتي
بروناى : بندر سرى بكاوان
مالديف : ماليه