الدولة :العاصمة
ايسلندا : ريكيافيك
اندورا : اندورا لا فيلا
البانيا : تيرانا
المملكة المتحدة : لندن
ايرلندا : دبلن
اوكرانيا : كييف
النرويج : اوسلو
ارمينيا : يريفان
السويد : ستوكهولم
استونيا : تالين
البرتغال : لشبونه
التشيك : براج
ايطاليا : روما
بولندا : وارسو
سويسرا : برن
فرنسا : باريس
صربيا : بلجراد
اذرابيجان : باكو
الدنمارك : كوبنهاجن
الجبل الأسود : بودغوريتشا
ايرلندا الشمالية : بلفاست
البوسنا و الهرسك : سراييفو
تركيا : انقرة
المجر : بودابست
اسبانيا : مدريد
الفاتيكان : الفاتيكان
سلوفينيا : لوبليانا
بلجيكا : بروكسل
بيلاروسيا : مينسك
جورجيا : تبليسى
روسيا : موسكو
موناكو : موناكو فيل
مولدافيا : كيشيناو
مقدونيا : سكوبيا
مالطا : فاليتا
لاتفيا : ريغا
اليونان : اثينا
قبرص : نيقوسيا
النمسا : فيينا
المانيا : برلين
كرواتيا : زغرب
بلغاريا : صوفيا
سلوفاكيا : براتيسلافا
رومانيا : بوخارست
لوكسمبورج : لوكسمبورج
لتوانيا : فيلنيوس
هولندا : امستردام
سان مارينو : سان مارينو
فنلندا : هلسنكى
كوسوفو : برشتينا
لختنشتاين : فادوز